16 17
4 10 15 16
# # # # # # # # # # # # # # # # #
# . . . . . . . . . . . . . . . #
# . # # # # # # # . # # # # # # #
# . . . . . # . # S # . . . . . #
# . # . # # # . # # # . # # # # #
# . # . . . . . . . # . . . . . #
# . # . # . # . # # # . # # # # #
# . # . # . # . . . . . . . . . #
# . # . # . # . # . # . # . # . #
# . # . # . # . # . # . # . # . #
# . # # # # # . # . # # # # # # #
# . . . # . . . # . . . # . . . #
# . # . # . # . # . # # # . # # #
# . # . # . # . # . . . # . . . #
# # # . # . # . # . # # # . # E #
# # # # # # # # # # # # # # # # #
