9 9
3 4 8 8
# # # # # # # # #
# . . . . . . . #
# . # S # . # . #
# . # . # . # . #
# . # . # . # # #
# . # . # . . . #
# . # # # . # # #
# . # . . . . E #
# # # # # # # # #