15 15
2 2 14 14
# # # # # # # # # # # # # # #
# S . . . . . . . . # . . . #
# . # . # # # # # # # # # . #
# . # . . . . . # . # . . . #
# . # . # # # # # . # # # . #
# . # . . . . . . . # . # . #
# # # . # . # # # # # . # . #
# . . . # . . . . . . . . . #
# . # # # . # # # # # . # . #
# . # . . . . . # . # . # . #
# . # # # . # # # . # # # # #
# . # . . . . . . . . . . . #
# . # # # . # . # . # # # # #
# . # . . . # . # . . . . E #
# # # # # # # # # # # # # # #