25 25
2 9 22 23
# # # # # # # # # # # # # # # # # # # # # # # # #
# . . . . . . . S . . . . . . . . . # . # . # . #
# . # . # . # . # # # # # # # # # # # . # . # . #
# . # . # . # . . . # . . . # . . . # . # . . . #
# . # # # # # . # # # . # # # . # # # . # . # # #
# . . . # . . . . . . . . . . . . . . . . . . . #
# . # # # # # . # . # . # . # # # # # # # . # # #
# . # . . . . . # . # . # . . . . . # . # . # . #
# # # # # . # . # # # # # . # # # # # . # # # . #
# . . . . . # . # . # . . . . . . . . . . . # . #
# . # . # . # # # . # # # . # . # # # . # # # . #
# . # . # . . . . . # . . . # . . . # . . . . . #
# . # . # . # # # # # # # . # . # # # . # . # . #
# . # . # . . . . . . . # . # . . . # . # . # . #
# . # . # . # . # # # # # # # . # . # . # . # . #
# . # . # . # . . . . . . . # . # . # . # . # . #
# . # # # # # . # # # . # # # . # # # . # # # # #
# . . . # . . . . . # . . . # . # . . . . . . . #
# . # # # # # . # # # . # . # # # . # . # . # . #
# . . . # . . . . . # . # . # . # . # . # . # . #
# . # . # # # . # # # . # # # . # # # . # # # # #
# . # . # . . . . . # . . . . . . . # . # . E . #
# # # # # # # . # # # # # # # # # # # # # . # # #
# . . . . . . . . . . . . . . . . . . . . . . . #
# # # # # # # # # # # # # # # # # # # # # # # # #