33 33
8 6 30 30
# # # # # # # # # # # # # # # # # # # # # # # # # # # # # # # # #
# . . . . . # . # . . . . . . . . . . . # . # . . . . . . . . . #
# . # . # # # . # . # # # # # # # . # # # . # . # # # # # # # # #
# . # . . . . . . . . . . . . . # . # . . . . . . . . . # . . . #
# # # . # . # . # # # . # . # # # # # # # # # . # # # # # . # # #
# . . . # . # . . . # . # . . . # . # . # . # . . . # . # . . . #
# # # . # # # . # # # # # . # # # . # . # . # . # # # . # . # # #
# . . . # S . . . . # . . . . . # . # . # . . . . . . . . . . . #
# . # . # . # . # # # # # . # # # . # . # . # # # # # . # . # # #
# . # . # . # . . . # . . . . . . . . . . . . . . . # . # . . . #
# # # . # # # . # . # # # . # . # . # . # # # . # # # # # . # . #
# . . . # . . . # . # . . . # . # . # . . . # . . . . . # . # . #
# . # . # # # . # # # # # . # # # # # . # # # # # . # . # . # . #
# . # . # . . . . . # . . . . . # . . . . . . . # . # . # . # . #
# # # . # . # . # . # . # . # # # # # . # . # # # # # # # # # # #
# . . . # . # . # . # . # . . . # . . . # . . . . . . . . . . . #
# . # . # # # . # . # . # . # . # # # . # . # . # # # . # . # # #
# . # . # . . . # . # . # . # . . . # . # . # . . . # . # . . . #
# # # . # . # . # . # . # . # . # # # # # . # . # . # # # . # # #
# . . . # . # . # . # . # . # . # . . . . . # . # . # . . . . . #
# . # . # . # . # . # # # . # . # # # # # . # # # # # # # . # . #
# . # . # . # . # . # . . . # . # . . . . . . . . . # . . . # . #
# . # # # # # # # . # # # . # # # # # # # . # . # # # # # . # . #
# . # . . . . . . . # . . . # . . . . . . . # . . . # . . . # . #
# # # # # . # # # . # # # . # # # # # # # . # # # # # . # . # . #
# . . . . . # . . . # . . . # . # . # . . . . . . . # . # . # . #
# . # . # . # . # . # . # # # . # . # # # . # # # # # # # # # # #
# . # . # . # . # . # . # . . . . . . . . . . . . . . . . . . . #
# # # # # # # . # # # # # # # . # . # . # . # # # # # # # # # # #
# . # . # . . . # . # . . . . . # . # . # . . . # . # . . E # . #
# . # . # # # # # . # # # . # . # . # # # . # # # . # . # # # . #
# . . . . . . . . . . . . . # . # . # . . . . . . . . . . . . . #
# # # # # # # # # # # # # # # # # # # # # # # # # # # # # # # # #