11 11
6 4 10 10
# # # # # # # # # # #
# . . . . . . . . . #
# . # # # # # # # # #
# . . . # . . . . . #
# . # . # . # # # # #
# . # S # . . . . . #
# . # # # . # # # # #
# . . . # . . . . . #
# . # # # . # . # # #
# . . . # . # . . E #
# # # # # # # # # # #